1111111111111
1001CCCCC00C1
10000CCCCC001
1P00101E000C1
1111111111111
