111111
1E00C1
100001
1000P1
111111
